0 0 0 0 0 0 0 0 0 0 0 0 0 0 0 0
0 0 0 0 0 0 0 0 0 0 0 0 0 0 0 0
0 0 2 2 2 2 2 2 2 2 2 2 2 0 0 0
0 0 2 2 2 2 2 2 2 2 2 2 2 0 0 0
0 0 1 1 1 1 1 1 1 1 1 1 2 0 0 0
0 0 2 1 1 1 1 1 1 1 2 2 2 0 0 0
0 0 2 2 2 2 2 2 1 2 2 2 2 0 0 0
0 0 2 2 1 1 1 1 1 7 8 2 2 0 0 0
0 0 2 2 1 1 1 1 1 1 7 2 2 0 0 0
0 0 2 2 1 1 1 1 1 1 1 2 2 0 0 0
0 0 2 2 1 1 1 1 1 1 1 2 2 0 0 0
0 0 2 2 7 1 1 3 1 1 1 2 2 0 0 0
0 0 2 2 7 1 1 1 1 1 1 2 2 0 0 0
0 0 2 2 2 2 2 2 2 2 2 2 2 0 0 0
0 0 2 2 2 2 2 2 2 2 2 2 2 0 0 0
0 0 0 0 0 0 0 0 0 0 0 0 0 0 0 0
